133,135,133,132,132,132,132,132,132,132,132,132,132,135
221,221,221,4,4,4,4,4,4,4,4,133,135,221
221,221,221,4,4,4,4,4,4,4,4,221,169,171
221,221,221,4,4,4,4,4,4,4,4,221,4,4
221,221,169,132,132,132,132,135,4,4,133,171,133,135
221,169,132,132,132,132,132,171,4,4,169,132,171,221
169,132,132,132,132,132,173,132,132,132,132,132,132,171
